N N W W W W W N
W W W . . . W N
W . . P W . W W
W . W BB . BS . W
W . . RS . W . W
W W . W RB . . W
N W . . . W W W
N W W W W W N N
N N N N N N N N